1111
1FF1
1011
10C1
1001
1001
1101
11P1
11E1
1101
1101
1001
1111