11111111111
1E00C011111
1110F111111
11000111111
111C0011111
1111100FC11
111FC000011
1111100P111
11111111111