111111
1C0001
10E001
10P001
111111