1111111
100P001
1E00C11
1111111