111111111
100E00101
100E00001
111111111