111111111
10P0C0101
1E00C0001
111111111