111111111
100E00001
100C0P001
111111111