1111111
1CCEEE1
1PPPEE1
1111111