111111111
100E00101
100C0P001
111111111