1111111
10C0E01
10P0001
1111111